saved_dungeons/01.rlg327
                                                                                
                                                                                
              .........#....>...                                                
              ......... <.......                                                
              ......... .......>                                                
              ......... ........                                                
              .........     #   ###########                                     
             #.........##########         #                                     
         ....#     #        #      ....   ####                                  
         ....      #        #      ....      ###                                
         ....      #        #######....#########........                        
         ....      #                            ........                        
                @...                            ........                        
                ....                            ........                        
                ....                                                            
                ....                                                            
                ....                                                            
                ....                                                            
                                                                                
                                                                                
                                                                                
saved_dungeons/02.rlg327
                                                                                
                                                                 .....###.<..   
                                    .......         #############.....###....   
                   ....             .......         #            .....   ....   
                   ....         ####.......##########            .....   ...<   
                   ....      .... ##                ##                   ....   
                   ....      .>..##                  ##                  ....   
                   >...######....                     ##                 ....   
                   .>..      ....                      ##                #      
                   ....         #                       ##               #      
                                #                        ##           ####      
                                #                         #           #         
                                #                         #           #         
                                #                         #       @....         
                                #                         #       .....         
                                #                         ....####.....         
                                .....                     ....                  
                                .....                     ....                  
                                .....                     ....                  
                                                                                
                                                                                
saved_dungeons/03.rlg327
                                                                                
                                                                                
                                                        ##############          
          @...                               ......######            #.....     
          ....                 ....          ......                   .....     
          ....                 >...          ......                   .....     
          #  ##########.....###....###########                        .....     
          #            .....                                          .....     
          #            .....                                            #       
          #            .....                                            #       
          #                                                ..........   #       
          #                                                ..........   #       
          >         #########################<#############..........#  #       
   ....##############                                                ##.......  
   ....                                                                .......  
   ....                                                                .......  
                                                                       .......  
                                                                       .......  
                                                                       .......  
                                                                                
                                                                                
saved_dungeons/04.rlg327
                                                                                
                                                                                
                                                                                
                                            ########<###......###########....   
                                           ##           ......           ....   
                                           #            ......           ....   
                                           #                             #      
        ......                             #                             #      
        ......              .....          #                             #      
        ......#########     .....          ###################           #      
        ......        ######.....###########                 #           #      
        ......                  #  #       ##                #############      
        ......                ......        ##                                  
             ##               ......         ##                                 
              ##########@...##......          #                                 
                        ....  ......          ###           ....                
                        ....  ......            ##          ....                
                              ......             ###########....                
                                                                                
                                                                                
                                                                                
saved_dungeons/05.rlg327
                                                                                
                ..........                                      @....           
                ..........          ......                      .....           
          ######..........          ...<..                      .<...           
  ....>....     ..........          ......                      .....           
  .........     ..........          ......##########........####.....           
  .........     ..........          #               ........    .....           
  .........     ..........          #               ........        #           
  .........#####..........######.........           ........        ###....     
  .........                     .........           ........           .<..     
  .........                     .........###########........###########....     
       #                        .........           ........           ....     
       #                        .........           ........           ....     
       #                        .........           ........           ....     
       # ....                   .........           ........                    
       # ....                   .........           ........                    
       ##....                   .........                                       
         ....                   ......<..                                       
                                                                                
                                                                                
                                                                                
saved_dungeons/06.rlg327
                                                                                
 .....       ....                                                               
 .....#######....                                                               
 .....     # ....                                                               
           # ....#                                                              
           ##    #<######@...                                                   
            #############....                             ........              
                         ....                             ........              
                         ....                        #####........              
                         ....                        #           ##             
                         ....###########            ##            #             
                                       .....######>##>########### #             
                                       ..>..                    ###             
                                       .....                      .......       
                                       ...<.                      .......       
                                       ...>.                      .......       
                                                                  .......       
                                                                  .......       
                                                                                
                                                                                
                                                                                
saved_dungeons/07.rlg327
                                                                                
                                                                                
                                                                                
  .....                                                                         
  .....                                                                         
  .....                                                        @...             
  ..<..                                                        ....             
  .....##                                .....#<###############....             
        <                                .....                    #             
        #           ............         .....                #######....       
        ....########............             #                #   #  ....       
        ....        ............          <....              ##   #  ....       
        ....        ............          .....             ##    ###....       
          #         ............#.....>###.....            ##                   
          #         #            ......   .....            #                    
          #         ##           ......   .....           ##                    
        ....         #           ......   .....          ##                     
        ....         #                                 ###                      
        ....         #######                          ##                        
                           ############################                         
                                                                                
saved_dungeons/08.rlg327
                                                                                
                                  .......>########....                          
                    ......        .......         ....                          
                    ......########.......         ....                          
                    ......      #                 ....##                        
                    ......      <                      #################        
                    ......      #                                      ##       
                    ......      .....                                   #       
                    #           .....                                   #       
                    #           .....                                   #       
              #######                                                   #       
             ##                                                         #       
            <>                                                          #       
       ......                                                           #       
       ......                                                          @....    
       ......                                                          .....    
       ......                                ##########################.....    
       ......###########>#####################                         .....    
                                                                                
                                                                                
                                                                                
saved_dungeons/09.rlg327
                                                                                
                                                                                
               ....                          ....  ######################@....  
               ....    ######################....###                     .....  
               ....   ##                     ....                        .....  
               ....  ##                      ....                        .....  
               .... ##                        #                          .....  
               .... #                         #                          .....  
               .... #                       ########                     #      
               .... <                       #      ##                    #      
               .... #                     ###       ##                   #      
               ....##                     #          ##....              #      
               #                          #            ....              #      
         ....  #                          #            ....              #      
         ....  #                          #            ....              #      
         ....  #                        ###                        ........     
         ....###                        #                          ........     
               ##                       #                          ......<.     
                #####                 ###                                       
                    ##########>########                                         
                                                                                
saved_dungeons/10.rlg327
                                                                                
                              ...>...                                           
          ....                .......                                           
          ....                .......                                           
          ....                .......                                           
             ###              #     ################                            
               #######################             #                            
                 #            #     #####......... ###                          
                 @.....     .....        .........   #                          
                 ......     <....        .........   #                          
                 ......#####.....                #   #                          
                                                 #   #                          
                                                 #   #                          
                                                 #   #                          
                                                 #   #                          
                                                 ............                   
                                                 ..........<.                   
                                                 ............                   
                                                                                
                                                                                
                                                                                
